Skolan för bioteknologi
Grundutbildningsansvarig: Universitetslektor Torbjörn Gräslund

Civilingenjörsexamen	
Bioteknik
Annika	Bendes
Kajsa-My	Blomdahl
Lucas	Bremer
Emelie	Falk
Susanne	Johansson
Hanna	Kafi Hassan
Maja	Marklund 
Sebastian	Ols
Linnea	Stenbeck
Hanna	Tano
	
Teknologie masterexamen	
Wojciech	Kazmierczak
Zahra	Mavajian
	
Skolan för kemivetenskap	
Grundutbildningsansvarig: Professor Mats Jonsson	
	
Civilingenjörsexamen	
kemivetenskap	
Lina	Aglén
Laurent	Arnau
Katerin	Ascue Avalos
Katia	Ascue Avalos
Valentin	Guigon
Alexandra	Holmgren
Josefin	Larsson
Frederik	Mathiason
Susanne	Mirsoyan
Martina	Montesino Malmberg 
Rebecka 	Olofsson
Sara	Starrsjö
Johan 	Wallinder
Baldassarre	Venezia
Lukas	Vikander
	
Högskoleingenjörsexamen	
Rikard	Mattsson Pilati
	
Teknologie masterexamen	
Christian	Mair
	
Skolan för vetenskaplig kommunikation och lärande	
Grundutbildningsansvarig: universitetslektor Susanne Engström	
	
Civilingenjörsexamen	
Civilingenjör och lärare	
Jonatan	Erdal
Mikael	Lovén
Caroline	Sundqvist
Henrik	Wiberg
	
Skolan för informations- och kommunikationsteknik	
Vice grundutbildningsansvarig:Universitetslektor Anders Västberg	
	
Civilingenjörsexamen 	
Informationsteknik	
Daniel	Carlsson
Adrien	Duffy-Coissard
Johan	Elander Aman
Linda	Eriksson
Jerry	Fan
Gabriel	Haglund El Gaidi
Zimon	Mossberg
Daniel	Olausson
Arash	Rezai
Nils	Ståhl
Wilhelm	Svenselius
	
Mikroelektronik	
Mohammad	Abdulla
Shaho	Moulodi
	
Högskoleingenjörsexamen	
Datateknik	
Vicky	Gandhi
Alex	Gezelbom
Maximilian	Scholz
	
Teknologie kandidatexamen	
Sofia	Hajzadeh Fallah
Linnea	Kylén Rönnqvist
	
Teknologie magisterexamen och masterexamen	
Sanaz	Mehdizadeh Namin
Rohit	Agrawal
Nikolaos-Ektoras	Anestos
Mona	Behzadineko
Debopam	Bhattacherjee
Rosa	Bonyadi
Lakshmi Narayanan	Chandrasekaran
Anand	Chinnapandian
Noor Uddin	Choudhury
Lorenzo	Corneo
Sandipan	Das
Maria	Haider
Riasat	Islam
Jing	Jin
Divya 	Kalkotwar
Shoaib	Khan
Elmira	Khodabandehloo
Bhanu Teja	Kotte
Antonios	Kouzoupis
Weifeng	Lin
Francesco	Martinelli
Fatemeh	Mirzaee Naeeni
Sumit	Mohanty
Somshree	Mukherjee
Misganu Dessalegn	Muruts
Vikrant	Nikam
Hidellage Ashansa Shammi	Perera
Kahahenage Don Ashila Kaushaly Shelan	Perera
Jiaheng	Qiu
Fahimeh	Rajabiyazdi
Ashok	Rajendran
Chathuri Lanchana	Rubasinghe Gunawardhana
Dawin	Schmidt
Sagar	Sharma 
Shikhar 	Singh 
Gayathri	Srinivaasan
Alexandra	Stagkopoulou
Krishna kumar	Thirukokaranam chandrasekar
Alessandro	Tomasi
Irene	Varoli
Tian	Xie
Eren	Yagdiran
Hang	Yu
Chencheng	Zhang
Soolmaz	Massoodian
	
Skolan för industriell teknik och management	
Grundutbildningsansvarig: universitetslektor Anna Jerbrandt	
	
Civilingenjörsexamen	
Design och produktframtagning	
Frida	Andersson
Paola	Alonso Chapel
Erik	Andrén
Elma	Basic
Lisa	Bysell 
Hadding	Delin
Oliver	Dover
Linn	Emilsson
Robin	Gradin
Jennifer 	Hansen
Nina	Haskovec
Jessica	Ho
Joanna	Jansson
Charlotte	Lindahl
Andreas	Lindegren
Hugo	Ljunggren Falk
Joakim	Oscarsson
Olivia 	Persson Hedin
Viktor	Sandqvist
Joel	Schröder
Markus	Selin
Malena	Sihvonen
Josefina	Sonnhammer
Amanda	Sten
Ola	Stålsmeden 
Johannes	Torres
Isak	Westin
Anders	Åström
Katja	Åström
Johanna	Österström
Fredrik	Ambrosson
Gustav	Solberger
	
Energi och miljö	
Malin	Berger
Måns	Böving
Amanda	Clarin
Emelie	Elmertoft
Lovisa	Eriksson Petersen
Anders	Falk
Vincent	Gliniewicz
Caroline	Hansson
Linnea	Heiskala
Pontus	Liljefors
Linus 	Linde
Mårten	Lundqvist
Anna	Persson
Victoria	Ronge
Jakob	Sahlin
Archit	Singh
Sara Elise	Trulsson
Sofia	Tyvik
Viktoria	Wiking
	
Industriell ekonomi	
Sara	Alexis
Åsa	Björndahl
Johan	Chen
Paulina	Erikson Brangstrup
Erik	Finnerman
Carlos	Gaitan
Liam Jafar	Hakim
Stephen	Kirk
Carl	Lindahl
Zakaria	#REF!
Johanna	Olsson
Erik	Poromaa
Sara	Walding
	
Maskinteknik	
Erik	Andersson
August	Brandberg
Kathrine	Bygren
Linda	Franzén
Jessica	Fredheim
Linda	Gustafsson-Ende
Jonathan	Holmström
Gustaf	Holst
Nadia 	Jamaleddine
Aina	Johansson
Carl	Kajnäs
Johan	Källmark
Patrik	Lans
Kristina	Larsson
Melinda	Laszlo
Patrik	Levin
Texas	Melander
Ryo	Nakakido
Jonas	Nilsson
Elin MK	Nordmark
Jonas	Persson
Robin	Prevolnik
Kristina	Sten
Victor	Sundin
Martin	Svanborg Östlin
Helena	Söderlund
Denise 	Thunström 
	
Materialdesign	
Yousef	Ahmad
Oskar	Altzar
Erik	Andersson
Klaudia	Karlström
Maryam	Khodahami
Jesper	Larsson
Kristoffer	Pettersson
Fia	Vikman
	
Högskoleingenjörsexamen	
Tina	Cheung
Sofia	Cederlund
Inés	Jamaleddine
Dany	Madjid
Pierre	Olsson
	
Teknologie kandidatexamen	
Annelie	Ähdel- Franzén
Carina	Ähdel- Franzén
	
Teknologie magisterexamen och teknologie masterexamen	
Syed Muhammad Farhan	Ali
Arokia Lourdu Marshall	Arokia
Roshan	Arun
Shoaib	Azizi
Maryam	Beheshti Monfared
Luis Miguel	Béjar Infante
Darya	Botkina
Georgios	Bris
Simon	Carlsson
Jason	Castillo Araújo
Mohammed Gofran 	Chowdhury 
Mattia	De Colle
Aline	De Santa Izabel Alves
Hongying	Du
Khaled	El-Musleh
Kerem	Erden
Alejandra Nundehui	Fabian Perez
Carlos	Figueira
Tobias	Goodden
Kim	Gutestam
Jenny	Hallberg
Saurav	Kalita
Yasemin 	Kus 
Emma	Kwon
Nikolaos	Lagopoulos
Renfei	Lang
Renfei	Lang
Yuxin	Li
Ninad 	Mutatkar 
Christina 	Papaioannou
Ioannis	Pappis
Muhammad Tabish	Parray
Amirali	Piadehbasmenj
Adriano	Polli
Anjan Rao	Puttige
Ursula	Raja
Malvina	Roci
Jonathan	Rodriguez
Carlos	Rojas Tena
María Alessandra	Salgado Gonzalez
Ajoqué	Santos
Aslan	Soltaninazarlou
Carla	Sundermann
Kasem	Tantanasiriwong
Josefine	Tarvainen
Janakiraman	Thiyagarajan
Jitin	Thomas
Elif	Toy
Ali Hilmi	Uysal
Serpil Sevilay	Uysal
Harikishan	Veluru Ramanaiah